### TAG
*File Format = txt
*HasFooter = no


#TAXPAYER INFO
*Name = Name
*TRN = AFM
*Status = Status
*Income = Income

#RECEIPTS
*Receipt Decleration = Receipts
*Receipt ID = Receipt ID
*Date: Date
*Kind =  Kind
*Amount =  Amount
*Company = Company
*Country = Country
*City = City
*Street =  Street
*Number = Number

#LOG
    //Name = Name:
    //TRN = AFM:
    //Income = Income:  
*Basic Tax = Basic Tax
*Tax Increase = Tax Increase
*Total Tax = Total Tax
*TotalReceiptsGathered = TotalReceiptsGathered
*Entertainment = Entertainment
*Basic = Basic
*Travel = Travel
*Health = Health
*Other = Other

